    #####
    #   #
    #   #
  ### #$##
  #      #
### #$## #   ######
#   # ## #####   .#
# $   $         ..#
##### ### #@##   .#
    #     #########
    #######